8 8
1 1 1 1 1 1 1 1
1 3 0 0 0 0 3 1 
1 0 1 0 0 1 0 1
1 2 3 0 0 3 2 1
1 0 1 0 0 1 0 1
1 0 5 6 7 8 0 1
1 3 0 9 0 0 3 1 
1 1 1 1 1 1 1 1