66 0
13 9
1 1 1 1 1 1 1 1 1
1 0 0 2 2 2 2 2 1
1 1 1 1 2 1 1 1 1
0 0 0 1 2 1 0 0 0
0 0 0 1 2 1 0 0 0
0 0 0 1 2 1 0 0 0
0 0 0 1 0 1 0 0 0
0 0 0 1 0 1 0 0 0
0 0 0 1 0 1 0 0 0
0 0 0 1 1 1 0 0 0
0 0 0 1 0 1 0 0 0
0 0 0 1 0 1 0 0 0
0 0 0 0 0 0 0 0 0
2
1 4 5 5 1 1 0 22983
1 4 1 7 1 0 0 38263
1 4 7 1 1 0 0 38263
6 3 57 57 0 0 3
