7 7
1 7 0 1 1 1 1
1 0 2 1 2 6 0
1 0 0 1 0 0 0
1 1 1 9 1 1 1
0 0 0 1 5 0 1
0 8 0 1 0 0 1
1 1 1 1 0 0 1