29 28
1 1 1 1 1 1 1 1 1 1 1 1 1 1 0 1 1 1 1 1 1 1 1 1 1 1 1 1
1 2 2 2 2 2 2 2 2 2 2 2 2 2 2 2 2 2 2 2 2 2 2 2 2 2 2 1
1 2 1 1 1 2 2 1 2 2 2 1 2 2 1 1 1 2 1 2 2 1 2 1 1 1 2 1
1 2 1 0 0 1 2 1 2 2 2 1 2 1 2 2 2 2 1 2 2 1 2 1 1 1 2 1
1 2 1 1 1 1 2 1 2 2 2 1 2 2 1 1 2 2 1 1 1 1 2 1 1 1 2 1
1 2 1 0 0 1 2 1 2 2 2 1 2 2 3 2 1 2 1 2 2 1 2 1 1 1 2 1
1 2 1 1 1 2 2 2 1 1 1 2 2 1 1 1 2 2 1 2 2 1 2 2 2 2 2 1
1 2 2 2 2 2 2 2 2 2 2 2 2 2 2 2 2 2 2 2 2 2 0 1 1 1 1 1
1 1 1 1 2 1 1 1 1 1 1 1 1 1 1 1 1 1 1 1 1 2 0 4 0 0 5 1
0 0 0 1 2 2 2 2 2 2 2 2 2 2 2 2 2 2 2 2 2 2 0 4 0 0 6 1
0 0 0 1 2 1 1 1 1 2 1 2 1 1 1 2 1 2 1 1 1 1 0 4 0 0 7 1
0 0 0 1 2 2 2 2 2 2 1 2 1 2 2 2 1 2 1 0 0 1 0 4 0 0 8 1
1 1 1 1 2 1 1 1 1 2 1 2 1 2 1 2 1 2 1 0 0 1 0 1 1 1 1 1
0 2 2 2 2 2 2 2 2 2 1 2 1 2 1 2 1 2 1 1 1 1 2 2 2 2 2 0
1 1 1 1 2 1 1 1 1 2 1 2 1 2 1 2 1 2 1 2 2 2 2 1 1 1 1 1
0 0 0 1 2 1 2 2 2 2 2 2 2 3 2 2 2 2 2 2 1 1 2 2 2 2 2 1
0 0 0 1 2 1 2 1 1 1 1 1 1 1 1 1 2 1 1 1 1 1 2 1 1 1 2 1
0 0 0 1 2 1 2 1 0 0 0 0 0 0 0 1 2 1 2 2 2 2 2 2 2 1 2 1
1 1 1 1 2 1 2 1 1 1 1 1 1 1 1 1 2 1 2 1 1 1 2 1 2 1 2 1
1 2 2 2 2 1 2 2 2 2 2 2 2 2 2 2 2 2 2 2 2 2 2 2 2 1 2 1
1 2 1 1 1 1 1 1 1 1 1 1 2 1 1 1 1 1 1 1 1 2 1 1 1 1 2 1
1 2 2 2 2 2 2 2 2 2 2 2 2 2 2 2 2 2 2 2 2 2 2 2 2 2 2 1
1 2 2 1 1 1 2 1 2 2 2 1 2 2 1 1 1 2 1 2 2 1 2 2 1 1 1 1
1 2 1 2 2 2 2 1 2 3 2 1 2 1 2 2 2 2 1 2 1 2 2 1 0 0 0 1
1 2 2 1 1 2 2 1 2 2 2 1 2 1 2 2 2 2 1 1 2 2 2 2 1 1 0 1
1 2 2 2 2 1 2 1 2 2 2 1 2 1 2 2 2 2 1 2 1 2 2 2 2 2 1 1
0 2 1 1 1 2 2 2 1 1 1 2 2 2 1 1 1 2 1 2 2 1 2 1 1 1 2 0
1 2 2 2 2 2 3 2 2 2 2 2 2 2 2 2 2 2 2 9 2 2 2 2 2 2 3 1
1 1 1 1 1 1 1 1 1 1 1 1 1 1 0 1 1 1 1 1 1 1 1 1 1 1 1 1
5
