13 7
1 1 1 1 1 1 1 1 1
1 0 0 2 2 2 2 2 1
1 1 1 1 2 1 1 1 1
0 0 0 1 2 1 0 0 0
0 0 0 1 2 1 0 0 0
0 0 0 1 2 1 0 0 0
0 0 0 1 0 1 0 0 0
0 0 0 1 0 1 0 0 0
0 0 0 1 0 1 0 0 0
0 0 0 1 1 1 0 0 0
0 0 0 1 0 1 0 0 0
0 0 0 1 0 1 0 0 0
0 0 0 0 0 0 0 0 0
1
1 1 1 1 1 0 0 100000
10 3 10 3 0 0